111111111111111111
1000000P0000000001
100000C0000000E001
100000000000000001
111111111111111111